sum=sum
avg=avg
round=round
floor=floor
ceil=ceil
rand=random
random=random
exp=exp
ln=ln
log10=log10
log2=log2
log=log
pow=pow
power=power
sqrt=sqrt
abs=abs
pmod=mod
sin=sin
asin=asin
cos=cos
acos=acos
tan=tan
atan=atan
degrees=degrees
radians=radians
sign=sign
pi=pi
e=e
cbrt=cbrt
width_bucket=width_bucket
get_json_object=json_extract_scalar